животно - animal
почти всичко - almost everything
невероятно - unbelievable
вероятно - probably
не все още - not yet
примерно - approximately
пример - example
преди всичко - above all
миналата - previous
преди - before
след - after
преди малко - a moment ago
излизам - go out
вземам - take
давам - give
отивам - go
използвам - use
слагам - put
ходя - walk
бягам - run
карам - drive
яздя - ride
дърба - fight/tear (contextual)
проклятие - curse
клетва - vow
опитвам се - try
бавнo - slow
може ли - can I / may I
да платя - to pay
плащам - pay
тук имам номерата за ток и вода - here I have the numbers for electricity and water
стъпих - I stepped
влизам - enter
изхвърлям - throw away
боклук - trash
казвам - say
говоря - speak
уча - learn
след малко - in a little while
тренирам - train
трябва - must / should
сметки - bills
горе-долу - more or less
уморен съм - I am tired
трябва да тръгвам - I must go
отново - again
повтори - repeat
чух - I heard
чувам - I hear
защото - because
защо - why
гладен съм - I am hungry
отивам да ям - I am going to eat
да ям - to eat
зает - busy
звъня - call (by phone)
звънец - bell
обикновено - usually
рядко - seldom
често - often
понякога - sometimes
лук - onion
по-късно - later
къпя се - taking a shower
чистя - clean
мия - wash
постоянно - all the time
заедно - together
удоволствие - pleasure
за мен е удоволствие - it’s a pleasure for me
подготвям се - I’m getting ready
гласове - voices
глас - voice
тежък - heavy
лек - light
светлина - light
тъмнина - darkness
тъмно - dark
посетя - visit
хапче - pill / medicine
гърло - throat
дълбоко - deep
плитко - shallow
случай - case
промени - changes
заменям - replace
твърд - hard
меко - soft
замяна - exchange
промяна - change
по-рано - earlier
будя се - wake up
събуждам се - wake up
много - a lot
започвам - begin
колкото - as much as
толкова - so much
интересно - interesting
още - more
още малко - a little more
разрешително - permit
разрешение - permission
пътувам - travel
отрова - poison
объркан - confused
огладнявам - getting hungry
маймуна - monkey
мръсен/мръсна - dirty
чист - clean
скоро - soon
най-скоро време - ASAP
скорост - speed
уважение - respect
бележка - note
последно/последен - last
чиния - plate
лъжица - spoon
вилица - fork
нож - knife
приключвам - finish
приложение - attachment / application
прилагам - attach
точност - accuracy
прицелвам - aim
досега - so far
следващ - next
зависи - depends
гърди - chest / breast
заключвам - lock
отключвам - unlock
гълтам - swallow
фактура - invoice
възможно - possible
невъзможно - impossible
успех - success
успешен - successful
рестото - change (money back)
помня - remember
колкото трябва - as much as needed
главоболие - headache
отвън - outside
представиш - imagine
търпение - patience
търпелив - patient
надежда - hope
надявам се - I am hoping
режа - cut
порязах се - I cut myself
по-скоро не - I’d rather not
идва - coming